i'm doordash ceo tony xu, and this is how i work	work how_i_work doordash
i'm katia beauchamp, birchbox co-founder and ceo, and this is how i work 	how_i_work work
i'm hallie jackson, nbc news correspondent, and this is how i work	how_i_work
i'm warren ellis, and this is how i work	how_i_work
five best paper notebooks	notebooks paper
five best budget pens	pens
most popular budget pen: pilot pens	pens pilot pilot_pens
best paper notebook?	paper
lifehacker readers' favorite notebooks	notebook
what's your favorite notebook?	notebook
five best mobile note taking tools	note_taking mobile
best mobile note taking tool?	note_taking
five best personal money management sites	money
best personal money management site?	money
five best personal finance tools	personal_finance
best personal finance tools?	personal_finance
five best photo sharing web sites	photo_sharing
best photo sharing web site?	photo_sharing
five best antivirus applications	antivirus
hack attack: host your own photo gallery with gallery2	hack_attack photo_gallery
flickr adds video	flickr
picasa goes online with web albums	picasa
is mint ready for your money?	money
mint manages your money	money
download of the day: simple budget spreadsheet	budget
download of the day: pearbudget spreadsheet	budget
manage your money with quicken online	money quicken
organize your money in 2008 with wesabe	money
manage your money with wesabe dashboard widget	dashboard_widget money
wesabe makes saving money social	money
manage your money with wesabe firefox uploader	firefox money
five best wysiwyg html editors	wysiwyg html editor
best wysiwyg html editor?	wysiwyg html editor
five best to-do list managers	to-do_list
best to-do list manager?	to-do_list
five best blogging platforms	blogging
best blogging platform?	blogging
five best food and nutrition tracking tools	food nutrition tracking
keep a daily food diary to track your diet, lose weight, and build healthy habits	diet food health weight diary food_diary
best food and nutrition tracking tool?	food nutrition
five best online backup services	backup online_backup
five best online backup tools	online_backup backup
sync files and folders outside your my dropbox folder	dropbox
five best file syncing tools	file_syncing syncing
best file syncing tools?	file_syncing syncing
five best windows backup tools	windows backup
best windows backup tools?	windows backup
five best windows maintenance tools	maintenance windows
best windows maintenance tools?	maintenance windows
five best desktop media players	media_players media_player top
hack attack: roll your own killer audio player with foobar2000	hack_attack
screenshot tour: the beautiful and varied world of foobar2000	screenshot_tour
sync your iphone wirelessly in linux	iphone linux wireless
jailbreak any iphone or ipod touch in 45 seconds	jailbreak iphone ipod_touch
jailbreak iphone 2.0 with pwnagetool	jailbreak iphone iphone_2.0
how to jailbreak your iphone: the always up-to-date guide [ios 9]	jailbreak how_to ios iphone
how to get the most out of your jailbroken ios device	ios how_to
theme it makes ios interface customization easy on jailbroken devices	ios customization
how to customize your jailbroken ios lockscreen	how_to ios
how to jailbreak your ios 4.2.1 device	jailbreak ios
greenpois0n brings a long-awaited untethered jailbreak to ios 4.2.1	ios jailbreak
how to install and set up ssh on your jailbroken ios device	ios ssh how_to
how to create a wi-fi hotspot on your jailbroken iphone	iphone wi-fi
get the most out of google voice on your iphone	iphone google_voice google phone
google voice for iphone is now (finally) available	google_voice iphone google phone
how to quickly customize settings on your jailbroken ios device	ios settings
how to infinitely extend your dock and homescreen on your jailbroken ios device	ios dock
how to install a vnc server on your jailbroken ios device	ios vnc
multifl0w brings webos-like multitasking to your jailbroken ios device	ios multitasking webos
how to quickly troubleshoot ios jailbreak issues with crashreporter	ios jailbreak crash
four reasons not to jailbreak your iphone, ipod touch, or ipad	jailbreak iphone ipad ipod_touch
how to backup your jailbroken ios apps with pkgbackup	backup ios
how to backup and restore your ios jailbreak applications with aptbackup	ios jailbreak backup restore
do you still jailbreak your iphone?	jailbreak
your quarterly jailbreak roundup, july 2014	jailbreak
ios 7.1.1 untethered jailbreak released	jailbreak ios ios_7
the best jailbreak apps and tweaks for ios 7	jailbreak ios tweaks
what's happening with the ios 7 jailbreak? should i use it?	jailbreak ios_7 ios
ios 6.1 jailbreak is now available	jailbreak ios
i'm new to jailbreaking; can you help me wrap my head around cydia?	jailbreak
sparrow+ makes sparrow your default email client on ios, adds push notifications for free	email sparrow ios notifications push_notifications
sparrow push enables push notifications in sparrow for iphone (jailbreak required)	sparrow iphone jailbreak
sparrow for iphone is a killer email app for iphone (with a catch)	email
the best email client for macos	email_client email mac
the lifehacker app directory curates the best apps for all your gear	app_directory apps lifehacker_app_directory
the lifehacker app directory: windows	windows
the best video player for windows	video windows
the best hidden features of vlc	vlc feature
five best desktop video players	video_players video desktop_video
what's the best desktop video player?	video desktop_video
most popular desktop video player: vlc	video desktop_video vlc
what media center software do you use?	media_center
set up an awe-inducing media center this weekend	media_center
how to get more from your home theater without paying a dime	home_theater
how to build your first home theater from nothing	home_theater how_to
how to put a movie theater in your home on the cheap	how_to
how to install xbmc on your apple tv 2	how_to xbmc apple_tv
build a silent, standalone xbmc media center on the cheap	xbmc media_center
customize xbmc with these five awesome skins	xbmc skins
transform your classic xbox into a killer media center	media_center xbox
turn your windows pc into a media center powerhouse on the cheap	media_center windows
hack attack: how to install a pci card	hack_attack how_to
add a web interface to your homemade dvr	dvr
hack attack: build your own dvr	dvr hack_attack
ipodifier video converter (windows)	video ipod
alpha geek: copy tv shows to your ipod	ipod alpha_geek tv
alpha geek: copy dvds to your ipod	ipod alpha_geek dvds
ultranewb: how to copy videos to your ipod	ipod ultranewb video
ultranewb: how to sync your ipod with itunes	ipod ultranewb itunes
download of the day 2: videora converter	video
drag and drop movie conversions for your ipod	ipod
download of the day: any video converter (windows)	video
geek to live: how to access a home server behind a router/firewall	geek_to_live home_server
geek to live: how to assign a domain name to your home web server	geek_to_live
8 killer windows media center plug-ins	media_center windows windows_media
hack attack: one-click dvd rips	dvd hack_attack
soup up your xbox media center	media_center xbox xbox_media_center
configure advanced file sharing with sharepoints	file_sharing
how to access a mac's files on your pc	how_to
how to mount a windows shared folder on your mac	how_to windows
how to set up a home ftp server	ftp
geek to live: set up a personal, home ssh server	geek_to_live ssh
geek to live: create your own virtual private network with hamachi	geek_to_live hamachi
download of the day: hamachix (mac)	hamachi
geek to live: how to set up a personal home web server	geek_to_live
geek to live: how to control your home computer from anywhere	geek_to_live
xbmc turns your mac into the ultimate media center	media xbmc
run xbox media center from a usb drive	xbox_media_center media_center usb_drive
xbmc for mac beta 3 released	xbmc_for_mac xbmc
mount a windows shared folder in linux	linux
xbmc 8.10 atlantis leaves beta	xbmc
xbmc 'atlantis' beta 1 released for all platforms	xbmc
how to jailbreak your 2g apple tv	apple_tv
how to install plex on your new apple tv	apple_tv plex
how to make all your video airplay-compatible	airplay video
stream any video to your apple tv, no pre-conversion required	video
how to build a hackintosh mini for a less expensive, faster mac	how_to hackintosh
how to build a hackintosh mac and install os x in eight easy steps	how_to hackintosh
build a hackintosh mac for under $800	hackintosh
the always up-to-date guide to building a hackintosh (macos sierra)	hackintosh mac macos
how to install os x 10.7.4 on your hackintosh	hackintosh how_to
how to build a hackintosh and install mac os x 10.7.2 using easybeast and multibeast	hackintosh mac_os_x mac how_to
how do i choose the right hardware when building a hackintosh?	hackintosh hardware
how to build a computer, lesson 1: hardware basics	hardware
how to craft the perfect computer spec list for your needs	how_to
the best pcs you can build for $300, $600, and $1200	build
how to build a computer: the complete guide	complete_guide
how i built the media center of my dreams for under $500	media_center
what should i use for my home theater pc: apple tv, nettop, old computer, or something else?	home_theater_pc home_theater tv apple_tv top
how to pick the right tv tuner for your diy dvr	tv_tuner tv dvr
set up a geeky media center that non-geeks can actually use	media_center
cut the cable for good with boxee and apple tv	boxee apple_tv tv
miro is your tivo for internet video	miro video
best video feeds?	feeds video
hack attack: get your tv season pass with democracy	hack_attack tv
build a cheap but powerful boxee media center	media_center boxee
dedicated boxee box to come preloaded with the popular media center	boxee
wire your living room over wi-fi with a bridge	wi-fi
stream divx/xvid video to your xbox 360	xbox
xbox 360 update supports divx and xvid video playback	video xbox
quickly convert your video for xbox 360	xbox video
take control of your music with winamp 5.5	winamp
media player show and tell	media_player show_and_tell
watch video downloads on your tivo for free	downloads tivo
favorite tivo tricks?	tivo
top 10 free video rippers, encoders, and converters	top
rip dvds with vlc	dvds vlc
play ripped dvds with vlc	dvd dvds vlc
convert video to any format with hey!watch	video
how to back up a dvd	dvd how_to
top 10 wi-fi boosts, tweaks and apps	top
turn your wifi router into a repeater	router wifi
turn your $60 router into a $600 router	router
how to supercharge your router with dd-wrt	dd-wrt
top 10 ways to boost your home wi-fi	wi-fi top
know your network, lesson 1: router hardware 101	101
how to ditch slow wireless speeds and go completely wired in your home (and why you should)	home wireless
how to go completely wireless in your home	wireless home
wi-fi analyzer finds the best hotspots and improves your home network	wi-fi network
boost your wireless signal with a homemade wifi extender	wifi wireless
improve your wireless devices' reception with a usb hub	reception usb
rain gutters as cable management tools	cable_management
hack attack: the cordless workspace (sort of)	hack_attack
top 10 ways to get cables under control	cables top
office supplies fetish: power plug id labels	office_supplies_fetish
cordless workspace redux, the gina edition	workspace
diy cable shortener	diy
keep your earbuds tangle-free with a diy cord wrapper	diy
diy recharging station	diy
binder clips as cable catchers redux	binder_clips
$5 ikea coat hanger offers solid cable management	cable_management
improve 3g modem reception with a kitchen pot	3g
boost your wi-fi signal with cooking strainer	wi-fi
detect wireless networks with netstumbler	networks wireless
manage wifi networks with istumbler	wifi
see network strength and security with wifind	wifi
call for help: wifi signal strength tool?	wifi call_for_help
boost your wi-fi antenna for less than a dollar	wi-fi
turn your iphone or ipod touch into a multi-room wireless music remote	music wireless ipod_touch
remote app controls itunes playback from your iphone	iphone itunes
turn your $60 router into a user-friendly super-router with tomato	router
share a printer on your home network	home_network
how to take wireless photos with your dslr and ios device	ios dslr
use ethernet connections for video chat and streaming, wi-fi for most everything else	wi-fi streaming video_chat
turn your old router into a range-boosting wi-fi repeater	router wi-fi repeater
creatively display your cables when hiding's not an option	display
hide cords in plain sight with flatwire	cords
why is wi-fi coverage so bad in my house, and how can i fix it?	wi-fi house
which wi-fi router should i buy?	wi-fi
what is mesh networking and will it solve my wi-fi problems?	wi-fi
everything you need to know about optimizing your wi-fi in one video	wi-fi video
how to extend your wi-fi network with an old router	router how_to wi-fi
what is 802.11ac and will it make my wi-fi faster?	wi-fi 802.11 802.11ac
tp-link wireless n150 mini pocket router is a great, super-cheap alternative to the airport express	router wireless
satechi wireless multifunction mini router solves many wireless internet needs with a tiny footprint	internet wireless
the features that matter on your next router (and the ones that don't)	feature
five best home wi-fi routers	routers wi-fi
what's the best home wi-fi router?	wi-fi
the best way to point your wi-fi router antennas: perpendicularly	wi-fi router
checkbox syndrome: why we spend money on things we don't need	money
when should i trust online reviews?	online_reviews reviews
detect fake online reviews by knowing the right words to look for	reviews online
hone your eye for fake online reviews	reviews
why i've stopped relying on online reviews for everything i buy	reviews
not being a troll isn't enough: a handbook to being a model internet citizen	internet
geek to live: how to deal with internet meanies	geek_to_live
how to stop caring about trolls and get on with your life	trolls
make quick work of internet trolls by using cognitive therapy	trolls
use text expansion to make quick work of assholes	assholes text_expansion text asshole
how to use text expansion to save yourself hours of typing every week	text text_expansion
lifehacker code: texter (windows)	texter lifehacker_code text windows
save time with text substitution	text text_substitution
hack attack: knock down repetitive email with autohotkey	email hack_attack
autokey does customized text replacement for linux	text linux
how to boost your reading comprehension by reading smarter and more conscientiously	reading reading_comprehension
how to start your information diet	information_diet
is google making you stupid?	google
why google isn't making you stupid	google
all about pipa and sopa, the bills that want to censor your internet	internet
stay on top of the fight against sopa/pipa with these tools	sopa top
lifehacker readers' solutions for your home's bad wi-fi coverage	wi-fi
the most important security settings to change on your router	security
what settings should i change on my wi-fi router?	router wi-fi
geek to live: set up a home wireless network	geek_to_live wireless
crack a wi-fi network's wep password with backtrack, the fancy video version	wi-fi wep
how to crack a wi-fi network's wep password with backtrack	wi-fi wep how_to
secure your home wi-fi network	wi-fi
how to crack a wi-fi network's wpa password with reaver	how_to wpa reaver wi-fi
how to monitor your internet usage so you don't exceed your data cap	how_to internet
get more out of your dd-wrt router with an external drive	dd-wrt
monitor your monthly bandwidth with your router	bandwidth
are you concerned about bandwidth caps?	bandwidth
download of the day: netmeter (windows)	windows
download of the day: freemeter bandwidth monitor (windows)	bandwidth windows
monitor your bandwidth usage with surplusmeter	bandwidth
a command line primer for beginners	command_line
geek to live: introduction to cygwin, part i	cygwin geek_to_live
geek to live: reader-written todo.txt manager	geek_to_live todo.txt
geek to live: introduction to cygwin, part ii - more useful commands	cygwin geek_to_live
geek to live: introduction to cygwin, part iii - scripts, packages and more	cygwin geek_to_live
find anything from the terminal	terminal
ask lifehacker: how do i customize my command line prompt?	ask_lifehacker customize command_line
ten handy bash aliases for linux users	linux
top 10 command line tools	top command_line
get help at the linux command line (beyond man)	linux command_line
unix ultranewb: how to rtfm	ultranewb
geek to live: mastering wget	geek_to_live
geek to live: mirror files across systems with rsync	rsync geek_to_live files
ctrl+r to search and other terminal history tricks	terminal
review your most oft-used unix commands	unix
useful command line tricks for mac users	command_line
geek to live: encrypt your web browsing session (with an ssh socks proxy)	ssh geek_to_live
geek to live: manage multiple firefox profiles	firefox geek_to_live
geek to live: top firefox 2 config tweaks	firefox_2 geek_to_live top
ie7 vs firefox 2: the memory usage showdown	ie7 firefox memory
the work-only firefox profile	firefox work
ask lifehacker: moving firefox to a new computer	ask_lifehacker firefox
ask the readers: how to keep naughty im's private?	ask_the_readers
geek to live: secure vnc with hamachi	vnc geek_to_live hamachi
turbocharge your terminal	terminal
turn your dd-wrt enabled router into a whole house ad blocker	router dd-wrt
how to pick a lock with a bump key	how_to
backtrack is a security-focused live cd packed with system tools	live_cd security tools cd
five best live cds	live_cd cds
best live cds?	live_cd live_cds
hive five winner for best live cd: backtrack	live_cd hive_five
five best movie cataloging tools	cataloging
best movie cataloging tools?	cataloging
hive five winner for best movie cataloging tool: delicious library	cataloging hive_five
five best media center applications	media_center media
boxee updates, adds support for netflix, windows on the way	boxee windows
atv usb creator loads boxee (and xbmc) on apple tv	apple x
boxee is xbmc with newer look and social flair	xbmc
geek to live: instant, no-overhead blog with tumblr	geek_to_live
boxee adds support for linux	linux
watch and schedule media center recordings from any computer	media_center
stream your music with orb	music
how to stream your music to any pc	music
geek to live: build an internet jukebox with jinzora	geek_to_live
listen to your itunes library anywhere with avvenu music player	itunes music
mediamaster: store, share and play your music collection online	music
backup, sync, and stream your music	music
get 25gb of free online storage at streamload mediamax	online_storage storage
back up your media with keepvault	media
vmcnetflix streams watch now videos to your xbox 360	videos xbox_360
stream netflix "watch now" movies, manage queue in media center with mynetflix	netflix
do more than just game on your xbox 360	xbox_360 xbox
turn your xbox 360 into a streaming netflix player	xbox_360 netflix
build a wi-fi adapter for your xbox 360 on the cheap	xbox
use your laptop as a free xbox wi-fi adapter	laptop top xbox
stream music from ubuntu to an xbox 360	ubuntu xbox
silence your xbox 360 with a new fan	xbox
turn your xbox 360 video cable into a vga cable	xbox
five best lifehacker code apps and extensions	lifehacker_code extensions
best lifehacker code apps and extensions?	lifehacker_code
hive five winner for best lifehacker code apps and extensions: better gmail 2	hive_five lifehacker_code extensions
better gmail 2 firefox extension for new gmail	better_gmail firefox gmail
gmail speeds up, improves contacts	gmail
yahoo mail innovates, gmail stagnates	gmail yahoo yahoo_mail
chat with aim, msn, yahoo, and other contacts over google talk	aim chat google_talk
google talk adds group chat	chat google google_talk
add google talk to your google homepage	google_talk google google_homepage
yahoo! mail unlimited storage kicks in	yahoo
download of the day: gdisk	gdisk
hack attack: getting good with google reader	google_reader hack_attack
hack attack: become a gmail master	gmail hack_attack
download of the day: google reader notifier (windows)	google_reader windows
download of the day: google reader notifier (mac)	google_reader
download of the day: google notifier	google
geek to live: from bloglines to google reader	google_reader bloglines geek_to_live google
download of the day: google reader notifier (firefox)	google_reader firefox
download of the day: google reader custom search (greasemonkey)	google_reader google greasemonkey
download of the day: smart google reader subscribe button (greasemonkey script)	google_reader greasemonkey
integrate google reader with gmail via greasemonkey	google_reader gmail greasemonkey
lifehacker code: better gmail (firefox extension)	gmail better_gmail firefox_extension lifehacker_code
hack attack: supercharge your gmail	gmail hack_attack
download of the day: gmail drive shell extension update	gmail
download of the day: customizegoogle	google customize
add encryption to gmail	gmail encryption
lifehacker code: supercharged gmailthis bookmarklet	gmail lifehacker_code
hack attack: bookmarking with gmail	hack_attack gmail
hack attack: firefox and the art of keyword bookmarking	firefox hack_attack
download of the day: openbook extension (firefox)	firefox
lh code: gmail date search (greasemonkey user script)	gmail greasemonkey search
download of the day: draganddropupload firefox extension	firefox
download of the day: gtdgmail	gmail gtd
access your google reader feeds offline with google gears	google google_reader offline
what gmail imap means for you (and your iphone)	gmail imap iphone
why imap is better than pop	imap
gmail updates its look, adds themes	gmail themes
gmail labs adds google calendar, other gadgets to sidebar	gmail_labs gmail gadgets google_calendar sidebar
always show the subject line when composing a gmail reply	gmail
set firefox 3 to launch gmail for mailto links	firefox_3 firefox gmail
five extensions you won't need with firefox 3	firefox_3 firefox
geek to live: supercharge your firefox downloads with downthemall	firefox downloads geek_to_live
ask lifehacker: gmail as default mail program	ask_lifehacker gmail
always show gmail's cc: field user script	gmail
"crowdsourcing a better gmail" presentation slides and notes	better_gmail
lifehacker code: about this site add-on (firefox)	firefox lifehacker_code
lifehacker code: the ly detector (greasemonkey user script)	lifehacker_code greasemonkey
lifehacker code: clipboard2phone (windows)	lifehacker_code windows
lifehacker code: dropcloth (windows)	lifehacker_code windows
lifehacker code: swept away (windows)	lifehacker_code windows
cut down on firefox memory hogging	firefox memory
automate timed mouse clicks with clickwhen	mouse
hack attack: using windows scheduled tasks	hack_attack scheduled_tasks windows
trick out google reader with better greader	google_reader
clean out old files with the windows janitor script	windows
geek to live: hard drive janitor	geek_to_live
dvd rip automates one-click dvd ripping	dvd ripping
mimic vista's file rename feature in xp	vista
turn any action into a keyboard shortcut: a beginner's guide to autohotkey	autohotkey
turn any action into a keyboard shortcut on your mac	mac
how to remap any keyboard shortcut in mac os x	mac_os_x
top 10 windows applications that should be on macs	windows top
top 10 mac applications that should be on windows	windows top
five best pdf readers	pdf_reader pdf
best pdf reader?	pdf_reader pdf
best pdf reader: pdf-xchange	pdf_reader pdf
five best instant messengers	instant_messenger
best instant messenger?	instant_messenger
best instant messenger: trillian astra*	instant_messenger
five best gps devices	gps
best gps device?	gps
best gps device: garmin nüvi	gps
five best content filtering tools	content_filtering
best content filtering software?	content_filter
best content filtering tool: opendns	content_filtering
runkeeper is like nike+ for your iphone—only better	runkeeper iphone
roll your own nike+ iphone for free	iphone
power up your buddy list with these awesome pidgin plugins	pidgin plugins
the best instant messaging application for windows	windows instant_messaging
the best instant messaging application for mac	instant_messaging
trillian 5 goes completely free, brings cross-platform chat log and im syncing to all devices	trillian im free
the best instant messaging application for linux	linux instant_messaging
what your im status says about you	im_status
consolidate your notifications and alerts with a single system for better awareness with less stress, windows edition	notifications windows alerts
how to automatically download tv shows as soon as they've aired (or turn your pc into a tivo)	how_to tv_shows
how to get started with usenet in three simple steps	usenet how_to
first look at the more mac-like microsoft office 2011 beta	mac microsoft_office
microsoft office 2011 for mac leaks to torrent sites	microsoft_office microsoft_office_2011_for_mac microsoft leaks
microsoft office 2011 for mac gets undressed	office microsoft microsoft_office mac
how does office web apps compare to google docs?	office_web_apps office google_docs google
office web apps offers free doc editing with 25 gb storage	office_web_apps office free
microsoft office web apps will be available to everyone	office_web_apps microsoft_office
turn live skydrive into a 25gb dropbox-style sync space	skydrive
skydrive explorer mounts your skydrive in windows explorer	windows
getting things done with microsoft onenote	onenote getting_things_done
gtd in a nutshell	gtd
getting things done with outlook and onenote 2007	getting_things_done outlook
google docs updates with a drawing editor, real-time collaboration, and speed	google_docs google collaboration drawing
windows 7 beta's many free and legit themes	windows_7 windows_7_beta themes
how to use custom windows visual styles	how_to windows
lifehacker pack 2010: our list of essential windows downloads	downloads lifehacker_pack_2010 windows
lifehacker pack for windows: our list of the essential windows apps	lifehacker_pack windows
top 10 incredibly useful windows programs to have on hand	windows
speccy gives you detailed information about your hardware	hardware information
download of the day: get system info with cpu-z	download cpu
download of the day: system information (windows)	windows information
the best system tweaker for windows	windows
what kind of maintenance do i need to do on my windows pc?	windows maintenance
what kind of maintenance do i need to do on my mac?	mac
clean up and revive your bloated, sluggish mac	mac
geek to live: complete, free mac backup	backup geek_to_live
geek to live: automatically back up your hard drive	geek_to_live
lh faceoff: mac backup software	mac backup
metadata as a 'filing system'	metadata
geek to live: mount a file system on your mac over ssh	ssh geek_to_live
top 10 ways to clean up your pc	top
prepare your mac for leopard	leopard mac
hack attack: how to install ram in your mac (and save big $$$)	ram hack_attack how_to mac
stop paying for windows security; microsoft's security tools are good enough	security windows top
the best antivirus app for windows	antivirus windows
how to disable avast's annoying sounds and popups	how_to avast popups
why you should use antivirus, even if you browse carefully	antivirus
the best app updater for windows	windows
ninite updater keeps windows apps up to date with one click	windows
ninite bulk-installs great free windows apps	windows
lifehacker pack 2009: our list of essential free windows downloads	downloads lifehacker_pack_2009 windows free
geek to live: lifehacker pack	geek_to_live
best text editors	text_editors
five best text editors	text_editors text editors
what's the best text editor?	text
top 10 must-have firefox extensions, 2009 edition	firefox_extensions firefox firefox_extension top
top 10 must-have firefox extensions	firefox firefox_extensions top
open wrapped urls with auto copy	urls
download of the day: autocopy firefox extension	firefox
gmail goes offline with google gears	gmail google google_gears offline
download of the day: tiny menu firefox extension	firefox firefox_extension
five best download managers	download_managers
google chrome first look	google_chrome google
download of the day: stealther firefox extension	firefox
enable chrome's best features in firefox	firefox
download of the day: download statusbar firefox extension	firefox
geek to live: fifteen firefox quick searches	geek_to_live firefox
get safari's best features in firefox	feature firefox safari
safari 3 beta now available for windows too	windows
four experimental firefox extensions we're into	experimental_firefox_extensions firefox_extension firefox_extensions firefox
gmail labs' new task manager can add email to your to-do list	gmail gmail_labs task_manager
keep google docs close at hand with gdocs sidebar	google google_docs
put documents online in one click with google docs uploader	google google_docs documents
upload google docs via email	google_docs email google
first look at songbird 1.0, aka itunes killer, aka sloppy mess	songbird
find mp3s with skreemr	mp3s
experimental firefox extensions no longer require login	firefox_extensions experimental_firefox_extensions firefox extensions
youtube hq automatically loads high-quality versions of youtube videos	youtube video videos
get download links to high quality youtube vids	youtube
get higher-resolution youtube videos with a url hack	youtube video videos
hack attack: back up and sync your firefox bookmarks with your personal server	bookmarks firefox hack_attack
synchronize firefox bookmarks with foxmarks	bookmarks firefox
yes, foxmarks beats google sync when it comes to bookmarks	bookmarks google
ask lifehacker: backup my browser bookmarks?	bookmarks ask_lifehacker backup
foxmarks bookmark syncing available for ie, safari	foxmarks syncing safari
how to use dropbox as the ultimate password syncer	how_to dropbox
five best password managers	password_managers
sxipper automatically fills in web forms	forms
geek to live: securely track your passwords	geek_to_live passwords
geek to live: choose (and remember) great passwords	passwords geek_to_live
how to import saved firefox passwords into keepass	keepass firefox how_to passwords
geek to live: secure your saved passwords in firefox	geek_to_live firefox passwords
download of the day: password exporter firefox extension	firefox firefox_extension
1password makes secure logins easier on iphones	iphone
lastpass saves and syncs passwords between all your browsers	passwords
passpack manages all your passwords online	passwords
foxmarks gets selective bookmark syncing	syncing
mozilla weave synchronizes your browsing experience	mozilla
foxmarks takes your bookmarks mobile	bookmarks
o-marks syncs your foxmarks bookmarks to your iphone	iphone foxmarks bookmarks
top 10 greasemonkey user scripts, 2009 edition	greasemonkey user_scripts user_script top
top 10 greasemonkey user scripts	greasemonkey scripts top user_script
download of the day: creammonkey (safari)	safari
hack attack: sync your greasemonkey scripts across computers	greasemonkey hack_attack
enable user scripts in google chrome	google_chrome user_scripts google
google chrome beta updates, boasts improved speed and new features	google_chrome google_chrome_beta chrome
five best alternative file managers	file_managers
best alternative file managers?	file_managers
replace windows explorer with xplorer2	windows
install greasemonkey scripts in safari with greasekit	greasemonkey
gmail macros updates for new gmail, adds productivity shortcut	gmail
download of the day: trixie (internet explorer)	internet_explorer
customize remember the milk with user styles	remember_the_milk user_styles
functional firefox user styles	firefox user_styles
geek to live: consolidate firefox's chrome	firefox geek_to_live
how to consolidate firefox 3's chrome	firefox firefox_3
five quick searches that turn firefox's address bar into a network command line	firefox quick_searches
ping servers from the firefox address bar	firefox ping
how to add quick searches to internet explorer	internet_explorer quick_searches
customize windows xp with tweakui	tweakui windows windows_xp
ask the readers: edit locations area in the open/save dialog box?	ask_the_readers
ask lifehacker: how do i stop focus thieves?	ask_lifehacker focus
windows explorer tip: make thumbnails bigger	windows_explorer windows
tweak your explorer sidebar with findexer and placesbar editor	explorer
power user's guide to firefox 3	firefox_3 firefox
top 10 firefox 3 features	feature firefox firefox_3 top
how to make your own smart bookmarks in firefox 3	firefox_3 bookmarks firefox how_to
the complete field guide to testing firefox 3	firefox firefox_3
firefox 3 beta 5 now available for download	firefox firefox_3
make your extensions work with the firefox 3.5	firefox
firefox 3 beta 3 now available	firefox firefox_3 firefox_3_beta
risk-free firefox 3	firefox_3 firefox
first look at firefox 3.0	firefox firefox_3
your favorite firefox 3 improvement?	firefox firefox_3
try out firefox 3 risk-free with a portable version	firefox_3 firefox portable
firefox 3 beta 5 easter egg	easter_egg firefox firefox_3 firefox_3_beta
firefox 3 rc 1 portable edition now available	firefox_3
shrink firefox 3's supersized back button	firefox_3 firefox
firefox tip: shift-delete mistyped autocomplete suggestions	firefox autocomplete
delete firefox auto-complete entries	firefox
add favicons to the bookmark toolbar	favicons
add favicons to the firefox bookmark toolbar	firefox icons
download of the day, part ii: favicon picker firefox extension	firefox
the history of firefox 1.0 to 3.0 in screenshots	firefox
help mozilla set a firefox 3 download record	firefox firefox_3
speed testing the latest web browsers	web_browsers browsers web_browser
firefox 3 to drop on tuesday	firefox_3 firefox
opera 9.5 still in the browser race	opera
stop safari on your pc	safari
tweak firefox to display richer colors	colors firefox
tweak the "awesomebar"'s suggestion algorithm	awesomebar
see how often you visit web sites in firefox 3	firefox_3 firefox
four extensions that tweak firefox 3's "awesomebar"	firefox_3 awesomebar firefox
disable blinking text in firefox	firefox
wine 1.0 runs hundreds of windows apps flawlessly	wine
remember the milk gadget puts tasks in gmail's sidebar	gmail remember_the_milk sidebar
six ways you should be using twitter (that don't involve breakfast)	twitter
follow and tip lifehacker editors on twitter	twitter
take launchy beyond application launching	application_launching launchy
run terminal commands in launchy	launchy terminal
download of the day: launchy 1.0 (windows)	windows
is enso the missing quicksilver app for windows?	windows
download of the day: colibri (not quite yet) quicksilver for windows	quicksilver windows
get and set reminders via twitter	reminders twitter
remember the milk with twitter	remember_the_milk twitter
geek to live: the command line comeback	command_line geek_to_live
technophilia: master google desktop search	desktop_search google google_desktop technophilia top
add events to gcal and why twitter may boost productivity yet	twitter productivity
screenshot tour: tweaking launchy	launchy screenshot_tour
feed your ego with rss	rss
how well does your name google?	google
use dodgeit to create an email rss feed	rss email
longurl expands short urls so you know where you're going	urls
expand tinyurls with embiggen	tinyurl urls
tiny url etiquette	etiquette
see where a tinyurl is pointing with tin foil hat	tinyurl
gmail puts unread message counts first in tabs, title bars	gmail
show message counts, chat alerts in your gmail favicon	gmail
display your unread message count in the gmail favicon	gmail
download of the day: faviconizetab (firefox)	firefox
download of the day: permatabs (firefox)	firefox
geek to live: ban time-wasting web sites	geek_to_live
useful firefox 3 configuration tweaks	firefox_3 firefox
make firefox 3's bookmarks available to launchy and quicksilver	bookmarks firefox firefox_3 quicksilver launchy
increase firefox's maximum pop-up count	firefox
how to skip the installation delay for firefox extensions	how_to firefox firefox_extensions
tweak about:config options with configuration mania	about:config
firefox 3 release full coverage	firefox_3 firefox
chat across im platforms with pidgin 2.4	chat im pidgin
postbox collects and organizes your email attachments	email attachments
hive five winner for best file compression tool: 7-zip	hive_five compression
five best file compression tools	file_compression compression
best file compression tools	file_compression compression
five best windows firewalls	firewalls
best windows firewall?	windows
hive five winner for best windows firewall: comodo firewall pro	hive_five windows
your favorite windows firewall software?	firewall
enable leopard's off-by-default firewall	firewall leopard
five best media converters	media_converters
best media converters?	convert
hive five winner for best media converter: handbrake	hive_five
five best sites to stream tv	tv
how dr. horrible's felicia day gets things done	felicia_day
five best dvd ripping tools	dvd_ripping ripping dvd
makemkv rips dvds and blu-rays with just two clicks	dvds blu-ray
vlc gets extension capabilities in nightly builds	vlc
turbo charge your new xbmc installation	xbmc
xbmc installer deluxe makes the most of your modded xbox	xbmc xbox
the best free video encoder for mac	video
best dvd ripping tool?	dvd_ripping ripping
ffmpeg your way to media conversion bliss	media_conversion ffmpeg media
how do i find and delete files of a certain type?	files
ask lifehacker: delete windows system files from my mac?	ask_lifehacker windows
dual os annoyances: turn off thumbs.db and .ds_store	annoyances
windows tip: rid your folders of thumbs.db	windows
gmail google desktop gadget now available	gmail google_desktop top
google calendar desktop gadget released	google_calendar gadget calendar top
everything finds windows files as you type	windows files
remote control your torrents with utorrent's webui	utorrent
control bittorrent downloads from your mobile phone with utorrent mui	bittorrent utorrent
start bittorrent downloads at home from any computer with dropbox	bittorrent dropbox
utorrent updates to 1.8, mac release looming	updates
download of the day: imgburn (windows)	burn windows
hack attack: burn almost any video file to a playable dvd	burn dvd hack_attack video
hack attack: automatically download your favorite tv shows	hack_attack tv
edit your digital photos with picasa	digital_photos picasa
organize your digital photos with picasa	picasa
upload picasa pics to flickr with picasa2flickr	flickr picasa
picasa 3 beta's new features	picasa
picasa updates, adds face recognition	picasa face_recognition
master your digital media with vlc	vlc
turn your pc into a dvd ripping monster	dvd
hack attack: how to install a hard drive	hack_attack how_to
browse and play your ripped dvds with dvd play	dvd dvds
play back ripped dvds in vista media center	dvds
copy music from your iphone or ipod to your computer for free	ipod music iphone
how to copy music from your iphone, ipad, or ipod touch to your computer for free	how_to iphone ipad ipod_touch music free
how to copy songs from your ipod to your pc	ipod
senuti copies music from your iphone or ipod touch to your mac	iphone ipod ipod_touch
transfer songs from your ipod to any mac with senuti	mac ipod
download of the day: yamipod	ipod
islsk soulseek client downloads music to your iphone and ipod touch	downloads iphone ipod_touch
grab mp3s from an iphone in windows with iphonebrowser	iphone mp3s windows
hack attack: add music and movies to your ipod from any computer without itunes	ipod hack_attack movies music itunes
hack attack: the self-sustaining ipod	hack_attack ipod
the 23 best itunes add-ons	itunes
the 20 best ipod utilities	ipod
download of the day: ipod -> folder (windows/mac)	ipod
move your music to another computer with your ipod	ipod
rip dvds to friendlier formats with handbrake	dvds
download of the day: videora ipod converter (windows)	ipod video
convert mp3 audiobooks for the ipod with mp3 to ipod audio book converter	audiobooks ipod
integrate your ipod and itunes with last.fm	last.fm ipod itunes
download of the day: ipod shuffle database builder (all platforms)	ipod
download of the day: ipodbackup	backup ipod
upgrade your ipod video to an ipod classic	ipod
put wikipedia on your ipod	ipod wikipedia
hack attack: play games on your ipod for free	ipod free games hack_attack
gift idea: rockboxin' mp3 player	rockbox
jailbreak your iphone or ipod touch with one click	iphone ipod ipod_touch
install third-party applications on your iphone	iphone
stream music from your ipod touch or iphone to any itunes library	iphone ipod itunes
control itunes with quicksilver	quicksilver itunes
hack attack: advanced quicksilver guide - slashes, appends, and proxies, oh my!	quicksilver hack_attack
hack attack: a beginner's guide to quicksilver	quicksilver hack_attack
using quicksilver's append	quicksilver
screenshot tour: a look under the hood of quicksilver	quicksilver screenshot_tour
video demonstration: the quicksilver "comma trick"	quicksilver video_demonstration
quicksilver menubar access	quicksilver
set quick timed reminders with quicksilver	quicksilver reminders
upload to flickr with quicksilver	quicksilver flickr
quicksilver google calendar quick add	quicksilver google_calendar
video demonstration: quicksilver proxies	quicksilver
mimic windows' "create new file" with quicksilver	quicksilver
control itunes from the menubar with you control: tunes	menubar itunes
download of the day: iconcertcal (windows/mac)	windows
a beginner's guide to bittorrent	bittorrent
how to boost your bittorrent speed and privacy	bittorrent how_to privacy
peerblock protects your privacy with less annoyance	peerblock privacy
peerblock protects your downloading privacy from prying eyes	peerblock
protect your privacy when downloading	privacy
caught downloading copyrighted material—now what?	copyright
five ways to download torrents anonymously	anonymous
tips for speeding up your torrents	tips
automatically download, convert and sync videos to your ipod	ipod video
download of the day: torrent	torrent
using bittorrent to send files	bittorrent
download of the day: opera 9	opera
automatically add new music to itunes with itunes folder watch	music itunes
hack attack: automatically sync itunes to any folder(s)	itunes hack_attack
free your music from itunes with itunes export	music itunes
download of the day: itunes export (windows)	itunes windows
download of the day: itunes agent	itunes
itunes sync transfers your itunes library to other mp3 players	mp3_players itunes
download of the day: xiphqt (windows/mac)	windows
screenshot tour: jajuk music player	music screenshot_tour
download of the day: drm dumpster (mac)	drm
download of the day: itunes remote control (mac)	itunes remote_control
automatically rate your itunes tracks with autorate (mac)	mac itunes
download of the day: soundflavor dj (windows)	windows
hack attack: top 13 itunes applescripts	itunes applescript hack_attack scripts top
geek to live: itunes power tips	itunes geek_to_live
killer add-ons make songbird so much better	songbird add-ons
songbird 1.0 release official, fixes bugs, plays itunes purchases	songbird itunes
dropbox syncs and backs up files between computers instantaneously	dropbox
backup files with mozy	mozy
eight best keepass plug-ins to master your passwords	passwords
geek to live: survive it lockdown	geek_to_live
avoid keyloggers with neo's safekeys	keyloggers
getting things done traveling through southeast asia	travel
geek to live: encrypt your data	geek_to_live
avg free anti-virus 2008 released, much improved	anti-virus
do you run antivirus software?	virus antivirus
superior alternatives to crappy windows software	windows software
what are your most hated default windows apps?	windows
go nearly flash-free on a mac with safari and chrome	flash safari chrome
youtube5 converts youtube videos to html5 for flash avoidance and cpu saving	flash html5 youtube cpu videos
internet explorer 9 screenshot tour: the best new features in ie9	screenshot_tour internet_explorer_9 internet_explorer
how i learned to love windows media player	media media_player windows
windows 7 media center's music player is hot hot hot	windows_7 windows_7_media_center music
hive five winner for best dvr app: windows media center	hive_five dvr windows windows_media_center
six best dvr applications	dvr
best dvr applications?	dvr
five best online job search sites	job_search
best online job search sites?	job_search
hive five winner for best online job search site: indeed	hive_five job_search
five best sites for finding deals online	deals
best sites for finding deals online?	deals
hive five winner for best site for finding deals online: slickdeals	hive_five deals
technophilia: craigslist for power users	craigslist
make your own firefox site search plug-in	firefox search
tips for applying for a job on craigslist	craigslist
hive five winner for best media center application: xbmc	hive_five media_center xbmc
windows media player 12 streams your media library over the internet	media_player windows media
the best music player application for windows	music_player windows music
winamp, our favorite media player for windows, is shutting down	winamp windows
five best desktop music players	music music_players player desktop_music_player
what's the best desktop music player?	music player desktop_music_player
five best pc gamepads	gamepads
how to turn your computer into a retro game arcade	how_to
how to turn your android or iphone into a portable retro game arcade	how_to iphone android portable
everything you need to know about rooting your android phone	root android
how to flash a rom to your android phone	how_to android
five best android roms	android roms
best android rom?	android
five best tablet drawing apps	drawing
best tablet drawing app?	drawing
five best web hosting companies	hosting hosting_companies web web_hosting
best web hosting company?	hosting web web_hosting
five best personal web hosts	web_hosts web
best personal web host?	web
five best bookmark management tools	bookmark_management
most popular tablet drawing app: sketchbook express/mobile/pro	drawing sketchbook
most popular android rom: cyanogenmod	android cyanogen cyanogenmod
miui is a gorgeous, super fast rom for android	android
how to speed up your old or sluggish android device	android speed
a guide to organizing your android home screen	android
smartbar combines the best android utilities into one menu bar app	utilities android
power strip adds a customizable shortcut and widget dock to android	android
battle of the android home screen launchers: adw vs. launcherpro vs. helixlauncher	android
android task killers explained: what they do and why you shouldn't use them	android task_killers
watchdog monitors your android for run-away processes	android monitor monitors
five great reasons to root your android phone	android
get root access in android with one click	android
g1 owners might be left out of future android updates	updates android g1
hack your wii for homebrew apps and dvd playback	wii dvd homebrew
hack your wii for homebrew without twilight princess	wii
how to back up and play your wii games from an external hard drive	how_to wii games
back up and play your wii games from an external hard drive	wii games
load your wii games from a hard disk, part ii	wii games
soup up your homebrew-hacked wii	wii homebrew
xbmc goes cross platform with atlantis	xbmc
play burned game backups on your wii without a modchip	wii
use your wii as a media center	media_center wii
pdanet tethers android phones to laptops with ease	android laptop laptops top
the best way to tether your iphone to your laptop (for free)	iphone top
at&t-approved iphone-to-laptop tethering coming soon	iphone
iphone modem tethers jailbroken iphones	iphone modem
get your computer online using your iphone's data connection	iphone
use your iphone's internet connection on your laptop	top iphone
share your mac's internet connection wirelessly	wireless
at&t iphone tethering will cost you	iphone
jailbreak iphone 2.0 on windows with winpwn	jailbreak windows iphone iphone_2.0
setcpu overclocks (or underclocks) your rooted android phone	android
the start to finish guide to rooting your motorola droid	droid
step-by-step guide to rooting and tethering a nexus one	tethering nexus_one rooting tether root
how to tether your android phone	how_to android tether
cyanogenmod 5.07 brings android 2.1 to g1 and mytouch phones	android cyanogenmod g1
do you root your android phone?	android
unlock and root a nexus one	nexus_one
simple root unlocks htc evo 4g in one click	evo_4g root
unrevoked3 painlessly roots the droid incredible, other htc android phones	android
universal androot roots most android phones, no pc or hacking required	android
this database of android roms helps you choose the best one for you	android roms android_roms
are roms really necessary on a nexus phone?	roms nexus
how to set up a fully automated app and settings backup on android	backup android
gapps manager gets you the right google apps for your rooted phone	google_apps google
top 10 reasons to root your android phone	android
get the android 4.2 camera and gallery on non-jelly bean phones	camera android_4.2 jelly_bean android
android 4.2 adds gesture-based typing, multiple users, actionable notifications, and more	android android_4.2
how to install netflix on almost any android device	netflix android
netflix brings instant streaming to android, will roll out gradually by device	netflix android
enable 720p video recording on the nexus 7's front-facing camera	nexus_7 video_recording video
get beats audio on any rooted android phone	android beats
the best music player application for android	music_player android music
battle of the android music players: the best alternative players compared	android
tunewiki puts lyrics, radio, and social features into mobile music	lyrics music
cubed is a much better music app for android	music android
how to choose the perfect pair of headphones	headphones
eminent speaker tests make sure you get the best sound from your home theater	home_theater
try new headphones or earbuds with old music before buying	headphones music earbuds
calibrate your hdtv?	hdtv tv
how to troubleshoot your hdtv picture	hdtv how_to troubleshoot
the best headphones you can buy under $20	headphones
five best headphones	headphones
best headphones?	headphones
five best headsets with attached microphones	headsets microphones
how to turn your favorite pair of headphones into a headset	headphones
the definitive guide to wrapping your headphones without losing your mind	headphones
top 10 diy miracles you can accomplish with a $1 binder clip	diy top
make a simple smartphone dock out of two binder clips	binder_clips
diy binder clip as cellphone tripod mount	diy
diy iphone binder clip dock	iphone diy
diy iphone or ipod touch paper clip stand	iphone ipod_touch diy
make an iphone/ipod stand from a business card	iphone ipod
make an ipod touch or iphone dock with a dollar bill	ipod iphone
task-defined binder clips for your hipster pda	hipster_pda binder_clips
leather gtd tabs makes binder clips look good	gtd binder_clips
mind.depositor gtd index card template	gtd
mind.depositor is a diy gtd super-notebook	gtd diy
mind.depositor 2: the all-leather, gtd super-notebook	gtd
how to ergonomically optimize your workspace	workspace
why and how i switched to a standing desk	standing_desk desk
coolest workspace contest: the treadputer	contest coolest_workspace_contest
build a diy wide, adjustable height ikea standing desk on the cheap	diy desk standing_desk
repurpose an ikea kitchen table as a sturdy standing desk	standing_desk desk
the improvised standing desk	desk
build your own custom ergonomic desk	desk
build a sturdy cardboard laptop stand	laptop_stand laptop top
top 10 diy laptop stands	diy laptop laptop_stand laptop_stands top
diy wine cork laptop stand	laptop diy
build a pvc pipe laptop stand	laptop top
stuff we like: elevator laptop stand	laptop stuff_we_like
make your own ring binder laptop stand	laptop laptop_stand
make your own laptop stand	laptop top
diy magnetic doorstop laptop stand	laptop_stand diy
diy laptop stand for the bed	diy
diy dual monitor stand	diy
make a diy monitor stand on the cheap	diy stand monitor
turn an ikea shelf and picture ledge into a monitor stand	ikea
diy tv or monitor stand from door stoppers	diy top
lifehacker labs: diy monitor stands, eyeglasses scratch removal, and more	lifehacker_labs monitor diy
lifehacker labs: everlasting razors, delicious turkey, and more	lifehacker_labs
learn the economical art of wet shaving	shaving
remove labels without tearing the box	labels
brine your thanksgiving turkey for juicier results	thanksgiving
recipes for brining a better thanksgiving turkey	thanksgiving recipes
lifehacker workspaces: adam pash edition	lifehacker_workspaces workspace
lifehacker workspaces: rosa golijan edition	lifehacker_workspaces workspaces workspace
armor etch removes scratched coating from glasses	glasses
convert your extra closet into a mini wine cellar	wine
set up a healthy, usable workspace	health workspace
lifehacker's coolest workspace contest - win $500 at amazon!	coolest_workspace_contest contest
download of the day: workrave (windows/linux)	windows
download of the day: antirsi (mac)	rsi
set yourself up for healthy computing	health
how to mouse goofy	how_to mouse
how to organize your desk	desk
geek to live: extreme makeover, filing cabinet edition	geek_to_live
hourly desk stretches relax your brain and body	desk
a guide to meditation for the rest of us	meditation
podcast introduction to basic meditation and mindfulness	meditation podcast
build a better brain with meditation	meditation
beat insomnia with blue energy	insomnia
top 10 ergonomic upgrades for your workspace	workspace work top
diy pipe stands for laptops and electronics	diy laptops top
$8 diy aluminum laptop stand	diy top
paper towel holder laptop stand	laptop
the handcrafted standing desk	desk
create a simple standing desk for $20	standing_desk desk
save your back and some cash with a diy standing desk	diy standing_desk desk
coffee table turned standing desk	desk
coolest workspace contest: the adjustable desk	coolest_workspace_contest contest
improve your sleep posture	sleep
top 10 ways to sleep smarter and better	sleep top
get a better night's sleep without electronic media	sleep
10 foods for a good night's sleep	sleep food
sleep on complex decisions	sleep
reboot your brain with a caffeine nap	caffeine
how to lucid dream	how_to
lucid dreaming how-to and faqs	lucid_dreaming
cheat sheet for power naps	nap
the best mouse you've ever had	mouse
what's the best mouse you've ever used?	mouse
extreme lifehacker home office makeover	home_office
learn the first steps to becoming an "unclutterer"	clutter
know what documents to shred and when you should shred them	documents
getting to done: the ultimate home office	home_office getting_to_done
coolest workspace contest: diy startup desk	contest coolest_workspace_contest diy
ask the readers: label maker recommendations?	ask_the_readers
wire your home on-the-cheap with diy network cables	diy
diy $8 home network rack	diy
use a mirror to light up a home office	home_office office
diy budget bias monitor lighting	diy
diy watch holder pantry light	diy
geek to live: the usable home	geek_to_live
dual monitors increase productivity	dual_monitor productivity
call for help: how do you personalize your workspace?	call_for_help
fight carpal tunnel with simple desk exercises	exercise
exercises that protect against carpal tunnel syndrome	carpal_tunnel_syndrome
schedule breaks and prevent rsi with time out	rsi
darken windows to reduce eye strain	windows
win an autographed copy of upgrade your life with your best life hack	upgrade_your_life
what we use: whitson gordon's favorite gear and productivity tips	what_we_use productivity
a comprehensive guide to sharing your data across multi-booting windows, mac, and linux pcs	windows linux mac sharing data
dual-boot windows 7 and ubuntu in perfect harmony	windows_7 ubuntu windows
customize ubuntu 9.10's grub boot screen	ubuntu boot customize
use a single data store when dual booting	dual_boot
firefox 2 officially released	firefox firefox_2
download of the day: firefox 2.0 (all platforms)	firefox firefox_2
early adopter download of the day: firefox 2.0 rc 1 (all platforms)	firefox firefox_2
download of the day: thunderbird 2.0 (all platforms)	thunderbird
download of the day: mozilla thunderbird 2 rc1 (all platforms)	thunderbird mozilla
early adopter download of the day: thunderbird 2 beta 1 (windows/mac/linux)	thunderbird
pidgin instant-messaging client (windows/linux)	linux windows
hack attack: how to triple-boot windows xp, vista, and ubuntu	ubuntu hack_attack how_to windows
ubuntu tip: how to mount a windows ntfs partition	ubuntu ntfs windows
download of the day: ext2 installable file system (windows)	windows
access linux files from windows with linux reader	linux windows
geek to live: encrypt your instant messages with gaim	aim gaim geek_to_live
schedule tasks in linux with gnome-schedule	linux
the beginner's guide to creating virtual machines with virtualbox	virtual_machine virtualbox
slipstream service pack 3 into your windows xp installation cd	windows_xp installation slipstream windows
geek to live: how to format your hard drive and install windows xp from scratch	windows geek_to_live
field guide to windows xp sp3	windows_xp_sp3 windows windows_xp
windows xp service pack 3 available on microsoft's servers	windows_xp windows
trim down windows to the bare essentials	windows
run windows apps seamlessly inside linux	linux windows
hack attack: how to run windows and mac apps side-by-side with parallels	parallels hack_attack how_to windows
hack attack: side-by-side windows and mac os with parallels	parallels hack_attack windows
download of the day: virtuedesktops (mac)	desktop top
hack attack: quick launch workspaces	hack_attack workspaces
run windows 7 for 120 days without activation	windows_7
extend vista's activation period	vista
windows 7 rtm activation already cracked	windows_7 activation windows
how to triple boot your hackintosh with windows and linux	triple_boot hackintosh linux windows
how to triple-boot your mac with windows and linux, no boot camp required	mac linux windows
the best improvements in ubuntu 10.04 lucid lynx	ubuntu_10.04 ubuntu lucid_lynx
first look at ubuntu 10.04 lucid lynx beta	ubuntu
ubuntu 10.04 to include built-in music store	ubuntu music
ubuntu one's online storage looks an awful lot like dropbox	ubuntu_one ubuntu online_storage dropbox
sugarsync offers 2gb of free windows/mac/mobile syncing	syncing windows
free online storage feature-by-feature comparison chart	online_storage
best online file sharing services	file_sharing
best online file sharing service?	file_sharing
box.net adds file collaboration	box.net collaboration
edit your images online with picnik	images
zoho writer online word processor	word_processor
publish your ical calendar for free on box.net	calendar ical
drop.io adds free, simple faxing	faxing
record long voice messages as mp3s at drop.io	mp3
get things done over the phone with jott	jott
jott + gmail = to-do list by phone	gmail
toodledo web-based todo manager	todo_manager
30 boxes calendar beta live	calendar
getting things done with nozbe	getting_things_done
cross-platform gtd apps?	gtd
getting things done with stikkit	stikkit getting_things_done
getting things done with google notebook	getting_things_done google google_notebook
get things done in outlook with jello	outlook
download of the day: igtd (mac)	gtd mac
geek to live: wget local copies of your online research (del.icio.us, digg or google notebook)	geek_to_live google_notebook research del.icio.us digg wget
get organized with gtdtiddlywiki	wiki gtd
add to-do lists to google calendar	google_calendar
remember the milk in gmail	gmail remember_the_milk
sandy's your personal assistant via email	email
filter your feeds with feed rinse	feeds
shut down windows remotely with an outlook filter	outlook windows
send snail mail via email with postful	mail email snail_mail
esnailer sends snail mail from the web	snail_mail mail
get 5gb of free online storage from skydrive	online_storage
sync your firefox extensions and profiles across computers	firefox firefox_extensions
best of the best: the hive five winners	hive_five best_of
five best bittorrent applications	bittorrent
best bittorrent tools?	bittorrent
five best calendar applications	calendar
best calendar application?	calendar
hive five winner for best calendar application: google calendar	hive_five calendar
how to sync any desktop calendar with google calendar	google_calendar top
google calendar adds caldav support, enabling ical sync	google_calendar calendar ical
calgoo goes free, syncs desktop calendars with google calendar	google_calendar top calendars
sync your gcal to outlook and back automatically	outlook
calaboration syncs ical and google calendar with ease	google_calendar calendar google
another free push calendar and contacts source for your iphone	contacts calendar
set up push email, contacts, and calendar on your iphone for free	contacts email push push_email iphone
geek to live: sync google calendar and gmail contacts to your desktop	google_calendar desktop geek_to_live top calendar
download of the day: lightning thunderbird extension	extension thunderbird
download of the day: rainlendar (windows/linux)	linux windows
rainlendar desktop calendar and todo list	calendar
mac os x's address book can now sync google contacts (update: for iphone owners only, ugh)	address_book google mac_os_x
enable google contact sync without an iphone or ipod touch	google iphone ipod_touch
google calendar gets better a little at a time	google_calendar
transmission updates, integrates remote control	remote_control updates
remote control your bittorrent downloads with clutch	bittorrent downloads remote_control
top 10 bittorrent tools and tricks	bittorrent top
download bittorrent files without a desktop client with bitlet	bittorrent top
stream music from bittorrent downloads with westream	bittorrent music
open source video player miro hits 1.0	video miro open_source
stop your isp from throttling bittorrent speeds	bittorrent isp top
youtorrent, your new favorite bittorrent site	bittorrent
your new favorite bittorrent site	bittorrent
manage your bittorrent downloads with transmission	bittorrent downloads
five best gtd applications	gtd
best gtd application?	gtd
remember the milk gets gears	remember_the_milk
best contact management applications	contact_management
best contact management tools?	contact_management
sync your contacts with plaxo	contacts
supercharge outlook with xobni	outlook
best rss newsreaders	newsreaders rss
alpha geek: trick out your netvibes	netvibes alpha_geek
alpha geek: start-page showdown	alpha_geek
customize your google homepage with themes	google_homepage google homepage themes
reader poll: what's your browser's homepage?	reader_poll homepage
reader poll results: browser homepage	poll
stream your mp3s with netvibes-slimserver mashup	netvibes mp3s mashup
netvibes distraction stopper greasemonkey script	netvibes distraction greasemonkey top
best application launchers	application_launchers
best application launchers?	application_launchers
the quicksilver-for-windows showdown	quicksilver showdown
dash throws another hat in the quicksilver-for-windows ring	quicksilver windows
new quicksilver for windows app skylight looks very promising	quicksilver windows
hack attack: the quicksilver video extravaganza	quicksilver hack_attack
download of the day: launchy 1.2.5 (windows)	windows
nine time-saving quicksilver triggers	quicksilver triggers
how to control multiple computers with a single keyboard and mouse	how_to keyboard mouse
quicksilver's creator on the future of qs	quicksilver
windows equivalents to quicksilver fall short	quicksilver windows
top 10 quicksilver plug-ins	quicksilver top
download of the day: rocketdock (windows)	windows
download of the day: stablauncher (windows)	windows
five best start pages	start_pages
best start pages?	start_pages
download of the day: opera 9.2 (all platforms)	opera
only2clicks.com simple homepage	homepage
make a modular start page with symbaloo	start_page
fix desynchronized video and audio with vlc	video audio vlc
online backup final round, mozy vs. carbonite	online_backup mozy
battle of the online backup services	online_backup
dropbox for linux adds online backup to desktop	linux online_backup backup top dropbox
geek to live: take great notes	geek_to_live
five best desktop search applications	desktop_search top
best desktop search application?	desktop_search
hive five winner for best desktop search app: windows search 4	desktop_search
hack attack: get more from google desktop	google_desktop hack_attack top
ten reasons to use google desktop	google_desktop google
locate32 finds files quickly and reliably	file files
improve your windows desktop search with windows search 4.0 preview	desktop_search top windows
what are the tools you can't live without?	tools
build a home ftp server with filezilla	ftp
ftp file transfer across platforms with filezilla 3.0	ftp file_transfer
download of the day: fireftp (firefox)	ftp firefox
five best ftp clients	ftp ftp_clients
best ftp clients?	ftp ftp_clients
hive five winner for best ftp client: filezilla	hive_five ftp
simple scan makes linux scanning beginner-friendly	linux
openshot 1.0 is an actually usable linux video editor	video linux
five features we want to see in ubuntu	ubuntu feature
appnr makes finding and installing ubuntu apps a breeze	ubuntu
gnome do's smart dock takes app launching to another level	gnome_do gnome dock
gnome do 0.8 brings great plug-ins, intuitive dock to linux	gnome_do linux gnome
get 3d compositing effects in linux without compiz	linux 3d
google releasing chrome operating system	google
google chrome as future operating system	google_chrome google
what to expect from google android (and what we're hoping for)	google_android google
forget the iphone—the ipod touch is good enough	ipod_touch iphone ipod
why you're better off avoiding the iphone	iphone
what's good (and free!) in the itunes app store	free
itunes 7.7 now available for download	itunes
iphone 2.0 software update unofficially available	iphone_2.0 iphone
upgrade from the unofficial to the official iphone 2.0 software	iphone_2.0 iphone
google optimizes for your iphone, fast and friendly	iphone google
google mobile searches your contacts and the web	google
jott your way to evernote bliss	evernote jott
evernote free today only, plus beta access	free evernote
the web-based vs. desktop-based newsreader showdown	newsreader top
desktop newsreaders feeddemon and netnewswire now free	newsreader top
google reader and talk get friendly	google_reader
web-based or desktop rss?	rss
netnewswire brings synced rss feeds to your iphone	netnewswire rss iphone
google reader iphone beta launches	iphone google google_reader
yelp maps business reviews	reviews maps
yelp brings location-aware reviews to your iphone	iphone reviews
how your location-aware iphone will change your life	iphone location-aware
google maps integrates wikipedia, geotagged photos	wikipedia google_maps photos
save benjis finds better deals, saves money from your iphone	money iphone
talking phrasebooks turns your iphone into a pocket translation dictionary	iphone
geek to live: send and receive money with your cell phone	geek_to_live money
what to do when you lose your cell phone	cell_phone
iphone 2.0 gets you laid (and more)	iphone iphone_2.0
friend book to beam your iphone's contact data with a shake	iphone
buy stuff on amazon with a text message	amazon
alpha geek: 10 cool cell phone tricks	cell_phone alpha_geek
geek to live: make a ringtone from any mp3	geek_to_live
create your own cross-platform backup server	backup
give an old laptop new life with cheap (or free) projects	laptop top
access your computer anytime and save energy with wake-on-lan	wake-on-lan
recycle your old computer into a print server	recycle
geek to live: set up your personal wikipedia	wikipedia geek_to_live wiki
build yourself an affordable media server	server
puppy linux 3.0 now available	linux
save a slow system with damn small linux	linux
alpha geek: turn an old hard drive into an external drive	alpha_geek
change windows drive letters	windows
turn your laptop into a wireless hot spot	laptop wireless
set up vnc on ubuntu in four steps	ubuntu vnc
lessons learned from a hacked gmail account	gmail
test your phishing iq	phishing
gmail adds multiple session info and remote signout	gmail
lifehacker laptop bags: how-to geek edition	laptop_bags laptop_bag top
lifehacker laptop bags: adam pash edition	laptop_bags laptop_bag top
lifehacker laptop bags: kevin purdy edition	laptop_bag laptop top
show us your go bag	go_bag
we want to see your "go bag"	go_bag
show us your go bag, part 2	go_bag
show us your go bag, part iii	go_bag
create, listen to, and share playlists at mixtape.me	mixtape.me
lifehacker laptop bags: jason fitzpatrick edition	laptop_bags laptop top
diy: make an altoids tin survival kit	altoids diy survival
how to dual boot windows 7 with xp or vista	windows_7 how_to dual_boot windows
hive five winner for best cd and dvd burning tool: imgburn	hive_five burning
five best cd and dvd burning tools	burning
best cd and dvd burning tools?	burning
five best desktop customization tools	top customization desktop
best desktop customization tool?	customization
hive five winner for best desktop customization tool: rocketdock	hive_five customization desktop
five best video chat applications	video_chat video
best video chat application?	video
google launches voice and video chat inside gmail	video_chat gmail google chat
hive five winner for best video chat application: skype	hive_five video_chat video skype
five best remote desktop tools	top remote_desktop
best remote desktop tools?	remote_desktop
hive five winner for best remote desktop tool: logmein	hive_five remote_desktop
five best travel sites for cheap tickets	travel
airlines cutting fares on holiday travel	travel airlines
best travel web sites?	travel
hive five winner for best travel site: kayak	hive_five travel
more travel deal web sites worth checking out	travel
track travel price changes with yapta tagger	travel
control tightvnc from the web	vnc
meebo adds video and voice chat to web-based im	chat im meebo
in-browser video chat with tokbox	chat video
go hi-res with skype video calls	skype video
skype 4.0 beta overhauls video chat	chat skype video_chat
geek to live: incorporate text files onto your desktop	desktop geek_to_live top
geek to live: list your life in .txt	geek_to_live
geek to live: quick-log your work day	geek_to_live
geek to live: map your time	geek_to_live
desk diary as productivity weapon	productivity
geek to live: keep your calendar in plain text with remind	plain_text geek_to_live calendar
roll your own lightning at sunset desktop	desktop top
download of the day: yod'm 3d (windows)	windows
screenshot tour: manage and organize your virtual desktop with dexpot	desktop screenshot_tour top
download of the day: dexpot (windows)	windows
download of the day: dm2 windows enhancer	windows
windows tip: make your own taskbar groups	taskbar windows
reorder your taskbar and system tray with taskbar shuffle	taskbar system_tray
download of the day: taskbar shuffle 2.0 (windows)	windows
d-color customizes your desktop icons	desktop top
make your taskbar transparent with transbar	taskbar
two-faced mac-like windows desktop	desktop windows
the mac meets windows dual-desktop	windows desktop
customize your own killer "enigma" desktop	desktop top
emerge alternative shell clears your desktop	desktop
windows vista with a live thumbnail sidebar	windows
burnaware free burns cds, dvds, and blu-ray	cds dvds
tackle all your cd/dvd writing with burnaware	burn
totally free burner makes cd and dvd burning simple	burning
ashampoo burning studio free handles all your burning needs	burning
download of the day: gparted live cd	live_cd
windows 7 system requirements less hungry than vista's were	windows_7 windows system_requirements
windows 7 beta available as free download on friday	windows_7 windows
windows 7 beta 1 out in the wild	windows_7 windows
windows 7 beta 1 coming january 2009	windows_7 windows windows_7_beta
top 10 things to look forward to in windows 7	windows windows_7 top
windows 7 will ship mid-2009	windows_7 windows
windows vista tip: disable the sidebar	windows_vista vista
microsoft gives up, strips default apps from windows 7	windows windows_7
windows 7 videos preview what's to come	windows_7 videos windows
windows 7 screenshots	screenshots windows
windows 7's calculator bundles real-life uses	windows_7 calculator windows
disable all balloon notifications in vista	notification notifications vista
windows vista tip: disable annoying "need your permission to continue-" prompts	vista windows_vista
make windows networking suck less?	windows windows_networking
geek to live: fast, one wire network (ip over firewire)	firewire geek_to_live
download of the day: gridmove (windows)	windows
windows 7 preview boots 20% faster than vista	windows_7_preview windows windows_7
windows 7, vista, and xp bootup benchmarks updated	windows windows_7
get windows 7's best features right now	windows_7 windows
iconize windows vista's taskbar (sort of like windows 7)	windows_vista windows taskbar windows_7
how to unlock the windows 7 preview's aero goodies	windows_7_preview windows_7 windows
a closer look at windows 7's aero peek feature	windows_7 windows
new windows 7 taskbar, peek feature look awesome	windows_7 windows
can windows 7 recover from vista?	windows_7 windows
aerosnap brings the windows 7 snap feature to xp, vista	windows windows_7
snap any window to half the screen size in windows 7	windows_7 windows
new "aero shake" clears the windows 7 desktop	windows windows_7
aero shake clears your pre-windows 7 desktop	windows windows_7
norton user account control makes uac less annoying	uac user_account_control
the complete guide to speeding up your pc's startup	startup
startup delayer staggers your startup apps for smoother loading	startup
schedule startup programs with startup delayer	startup
debunking common windows performance tweaking myths	windows performance
tweak windows prefetch for a faster startup	windows
microsoft's advice on how to speed up vista	microsoft
speed up windows with a flash drive	windows
hack attack: how to install ram	hack_attack how_to ram
power up windows calculator with power calculator	calculator windows
power replacements for built-in windows utilities	utilities windows
take your text editor to go with notepad++ portable	text text_editor portable
download of the day: paint.net 3 (windows)	windows
download of the day: alt-tab powertoy (windows)	windows
quickmonth taskbar calendar	taskbar calendar
download of the day: poderosa 4 (windows)	windows
download of the day: xecutor (windows)	windows
download of the day: alzip (windows)	zip windows
top 10 free windows downloads	downloads top windows
geek to live: top windows tweaks	windows geek_to_live top
get the windows 7 calculator in vista	windows calculator windows_7
blue badge updated, enables aero peek	aero_peek aero
the blue badge unlocks windows 7 preview's protected features	windows_7_preview windows
actionoutline is a blazing fast, hierarchical note organizer	organizer
expand your brain with evernote	evernote
portable windows movie maker resurrects missing features	windows
six best video editing applications	video_editing video
best video editing software?	video_editing video
hive five winner for best best video editing software: final cut pro	video_editing video
testdrive virtualizes brand-new ubuntu builds for easy testing	ubuntu
move ubuntu's window buttons back to the right	ubuntu buttons
arrange the window buttons in gnome	gnome
hide partition icons on gnome desktops	desktop gnome icons
ubuntu 10.04 gets cloud-based contact syncing	ubuntu syncing
download of the day: burn (mac)	burn
mac tip: how to burn an .iso or .dmg file to disc	how_to
download of the day: ophcrack live cd	live_cd
build a killer customized arch linux installation (and learn all about linux in the process)	linux arch_linux installation
why does everyone hate windows 8? should i upgrade?	upgrade windows_8 windows
how to bring the start menu back in windows 8	windows_8 start_menu
how to not get lost in windows 8: the best shortcuts and tricks	windows_8 windows shortcuts
add a shutdown button to the windows 8 start menu	windows_8 windows
the best application launcher for windows	application_launcher windows
why you should be using an app launcher (and how to make it do more than launch apps)	how_to
from the tips box: launchy keywords, masking tape notes, and bookmark abbreviations	from_the_tips_box tips
turn an old computer into a networked backup, streaming, or torrenting machine with linux	backup linux
turn an old pc into a nas, vpn, media streamer, and more with amahi	nas vpn amahi
amahi turns old systems into full-featured media servers	media_server server servers
turn an old computer into a do-anything home server with freenas 8	freenas home_server nas
turn an old computer into a networked backup, streaming, or torrenting machine with nas4free	nas backup
what operating system should i use for my diy home server?	home_server diy
use windows 8 as a windows home server	windows_home_server windows_8 windows
five best nas enclosures	nas enclosures nas_enclosures
best nas enclosure?	nas
five best computer monitors	monitors computer_monitors
most popular computer monitor: apple thunderbolt 27” display	apple
most popular hive fives of 2012	hive_five
five best android launchers	android launchers
best android launcher?	android
five best internet radio services	internet_radio radio internet
best internet radio service?	internet_radio radio internet
most popular internet radio service: pandora	internet_radio radio internet pandora
tunein radio streams local radio stations on almost any platform	radio radio_stations
spotify now available to users in the us	spotify us
spotify is the best desktop music player we've ever used	spotify top music
bad apple: an argument against buying an iphone	iphone bad_apple
spotify officially coming to the us; sign up for an invite now	spotify
songza picks the right streaming music playlist for any mood	music streaming_music mood
most popular android launcher: go launcher ex	android go_launcher ex
do you have ice cream sandwich yet?	ice_cream_sandwich
first look at the highly polished android 4.0, "ice cream sandwich" [updated with video]	ice_cream_sandwich android_4.0 android
holo launcher brings the ice cream sandwich launcher to any android phone	android ice_cream_sandwich
five best android web browsers	android browsers web_browsers web
best android web browser?	android web
the best web browser for android	android
which browser is better for privacy?	privacy
many browser extensions have become adware or malware. check yours now	malware adware
why do chrome extensions need to access all my data?	chrome_extensions chrome
everywhere you can enable "do not track"	do_not_track
what "do not track" is and why it's important	do_not_track
fact and fiction: the truth about browser cookies	cookies
web sites using flash instead of browser cookies to track your activity	cookies
betterprivacy prevents tracking by flash, other "super-cookies"	privacy flash cookies
what "do not track" doesn't do	do_not_track
everyone's trying to track what you do on the web: here's how to stop them	how_to top
facebook is tracking your every move on the web; here's how to stop it	facebook tracking top
priv3 selectively stops third-party sites from sending your info to facebook, google, twitter, and more	facebook google twitter top
do not track plus stops ad companies and others from tracking you online	do_not_track
the best web browser for iphone	iphone
meteoric download manager is the missing file downloader/uploader your iphone needs	iphone
twitter wants to start tracking you on the web, here's how to opt-out	twitter tracking
twitter is tracking you on the web; here’s what you can do to stop it	twitter tracking top
twitter is now sending you weekly email digests; here's how to turn them off	twitter
paper.li curates twitter links into a personal news-style digest	twitter links
the best browser extensions that protect your privacy	privacy extensions
why you should care about and defend your privacy	privacy
how to tell if your credit card was hacked in the global payments breach [updated]	credit breach global_payments
skip the identity theft coverage and similar credit card perks to save money on fees	fees credit money perks
double-check your bill every month to avoid fees for unwanted "services"	fees
collusion for chrome shows you who's tracking you on the web, as you browse	tracking chrome
collusion for firefox shows you who’s tracking you on the web in real time	tracking firefox
disconnect for chrome disables third-party tracking while keeping webapps operational	chrome
how much do you care about your online privacy?	privacy
everything you can do with adblock plus (that isn’t just blocking ads)	adblock ads
how to make facebook infinitely better with one browser extension	facebook
better facebook makes the new facebook font readable, adds tons of other tweaks	facebook
f. b. purity hides annoying facebook applications and news feed updates	facebook
five best facebook customizers	facebook
best facebook customizer?	facebook
how to kill the facebook news ticker	facebook
five best fitness tracking web sites and services	fitness tracking
best fitness tracking web site or service?	fitness tracking
six best exercise planning and tracking tools	exercise tracking
best exercise tracking or planning tool?	exercise tracking
hive five winner for best exercise tool: runkeeper	hive_five exercise
five best journaling tools	journal
diy nike+ipod shoe mod	ipod diy
minimalist facebook cleans up facebook's interface	facebook interface
your facebook has two inboxes, and you've probably missed messages from the second	facebook inbox
how to get rid of facebook timeline, bring back a simpler profile view	facebook facebook_timeline timeline
facebook timeline heading to all profiles	facebook timeline facebook_timeline
how to use facebook's new timeline feature (and hide your embarrassing old posts)	facebook how_to timeline
timeline is now available for all facebook users	facebook
the always up-to-date guide to managing your facebook privacy	facebook privacy
facebook introduces new, uber-simple privacy controls	facebook privacy
firesheep sniffs out facebook and other user credentials on wi-fi hotspots	wi-fi facebook
https everywhere encrypts connections whenever it's possible	https
google offers encrypted ssl searches	google ssl search
from the tips box: google ssl, stuttering audio, and cleaning blenders	from_the_tips_box tips
why should i care about https on facebook (or other web sites)?	https
why does chrome think gmail is insecure?	gmail chrome
gmail making secure https connections a default	gmail
google to stop censoring search results in china	google china
facebook disconnect removes annoying facebook clutter from other web pages	facebook
block sites from using your facebook login with adblock plus	facebook
save yourself from weiner-caliber online embarrassment with internet shame insurance	internet_shame_insurance embarrassment weiner
pimp your facebook: how to create a badass timeline banner	facebook
how to add facebook chat to your im client	facebook im chat
aim integrates facebook chat, status updates	facebook aim chat im
google buzz explained	google_buzz google
how (and why) to set up a secondary browser optimized for slow internet connections	internet
browser speed tests: firefox 4, internet explorer 9, chrome 11, and more	browser_speed_tests firefox_4 internet_explorer_9 chrome
how we test web browsers	web_browsers
what's new and awesome in firefox 4	firefox_4 firefox
use firefox's tab panorama as a to-do list	tab_panorama
use a custom wallpaper to organize your desktop as a to-do list	wallpaper desktop
from the tips box: desktop to-dos, headphone jacks, and quick playlists	from_the_tips_box tips
embed your to-do list onto your desktop	desktop to-do_list top
put remember the milk on mac desktops with geektool	geektool remember_the_milk desktop
geek to live: monitor your mac and more with geektool	geek_to_live
firefox's awesome tab candy renamed panorama, to be included with sync in firefox 4	firefox firefox_4
bartab lightens firefox's tab load to avoid crashes	firefox
bartap keeps tabs in limbo to conserve system resources	tabs
chrome's about:labs page lists experimental features for dev build users	chrome
move your tabs to the side in google chrome for widescreen-friendly browsing	google_chrome chrome
google now updating stable chrome builds every six weeks	chrome
how to enable extension syncing in chrome (aka: the holy grail of browser sync is here)	syncing chrome
web store link shows up in chrome, webapps likely coming soon	chrome web_store webapps
try out three early web apps from the chrome web store now	chrome_web_store chrome
google chrome’s ui designer discusses shortcuts, productivity, and the future of chrome os	google chrome_os google_chrome
the power user's guide to google chrome	google_chrome chrome google
the always up-to-date power user's guide to chrome	chrome
how and why chrome is overtaking firefox among power users	chrome firefox
browser speed tests: safari 5, firefox 3.6, chrome 6, and opera 10.6 beta	browser_speed_tests
browser speed tests: the windows 7 results	windows_7
google chrome beta adds bookmark sync, speed boost	google_chrome
how to enable bookmark syncing in chrome, without an add-on	chrome
xmarks comes to chrome, syncs bookmarks with all your browsers	xmarks bookmarks
browser speed tests: chrome 4.0 and opera 10 take on all challengers	speed_tests opera_10 opera
firefox director talks firefox 3.6, tasks, and competing with chrome	firefox firefox_3.6
lifehacker speed tests: safari 4, chrome 2, and more	safari
browser speed tests: how safari 4 stacks up	safari
safari 4 beta adds cover flow, runs "3x faster" than firefox	safari_4 safari
a hands on look at safari 4's (crashy) eye candy	safari
foxtab brings innovative, attractive tab switching to firefox	firefox
firefox 3.1 new features already in the works	firefox_3 firefox
firefox 3.5 "preview" available with an update check	firefox firefox_3.5
browser speed tests: firefox 3.6, chrome 4, opera 10.5, and extensions	browser_speed_tests
how html5 will change the way you use the web	html5 html
first glimpse at google chrome os	chrome_os google_chrome_os google google_chrome
firefox sync to incorporate bookmark, password, preference, history, and tab sync directly in firefox	firefox history
weave 1.0 syncs nearly everything about your firefox setup	weave firefox
firefox mobile 1.0 rc3 available for maemo, disables flash by default	firefox_mobile firefox flash
mozilla vp on what firefox mobile means for your phone	firefox_mobile mozilla
a closer look at fennec, the mobile firefox browser	firefox
a hands-on first look at google android	android google_android
firefox home app will sync your browsing to your iphone	firefox iphone sync
gmail adds drag-and-drop attachment uploads, deeper calendar integration	gmail
gmail adds drag-and-drop picture insertion	gmail
gmail adds drag-and-drop saving for attachments	gmail attachments
gmail on safari 5 supports drag-and-drop attachments, stay-open windows	gmail safari attachments
keep your gmail tasks, chat, and compositions open in new chrome windows	gmail chrome
chrome to phone sends links, text, and numbers to android almost instantly	android chrome links
android2cloud opens urls from your phone in chrome	android chrome urls
nine great uses for private browsing that don't involve porn	private_browsing
how to build a chrome extension	how_to chrome
learn to code: the full beginner's guide	code
learn how to code part i: variables and basic data types	code
learn how to code this weekend	code
programmer 101: teach yourself how to code	teach_yourself how_to
how to build a web application from scratch with no experience	how_to
top 10 apps worth installing adobe air for	adobe_air top
snackr rss ticker keeps you on top of news	rss top
klok tracks time and projects simply	project
readair brings google reader to your desktop	google_reader top
geek to live: improve your web site with google analytics	geek_to_live google
best first programming language to learn?	programming
learn to code part ii: working with variables	code
learn to code part iii: arrays and logic statements	code
learn to code part iv: understanding functions and making a guessing game	code
learn to code epilogue: best practices and additional resources	code best_practices
how to make a web site: the complete beginner's guide	web_site
how to make a web site part i: understanding and writing html	web_site html
how to make a web site part ii: styling and css	web_site css
how to make a web site part iii: a site from start to finish	web_site
basics of photoshop: designing a website	photoshop design
how to make a web site part iv: choosing a host and launching your site	web_site
five best domain name registrars	domain_name_registrars registrars
how to make a web site part v: additional resources	web_site
top 10 must-have browser extensions	browser_extensions extensions top
how to set up multiple homepages in firefox	firefox
get more omnibox suggestions in google chrome	google_chrome
google chrome's full list of special about: pages	google_chrome
google chrome's about:internets easter egg	google_chrome easter_egg
top 10 software easter eggs	easter easter_egg top
firefox 3 beta 4 now available	firefox firefox_3
flight simulator in google earth 4.2	google google_earth
google earth adds sky	google google_earth
easter egg hunt 2006, open office star wars game	easter_egg open_office
how to block ads in google chrome	google_chrome
battle of the must-have firefox extensions	firefox firefox_extensions
mozilla crowns best firefox 3 extensions	firefox_3 firefox mozilla
tagmarks makes it easy to tag your firefox 3 bookmarks	firefox firefox_3
read it later adds firefox 3 integration, offline reading	firefox firefox_3
tagsifter slices and dices your bookmarks by tag	bookmarks tags
bookmark previews creates thumbnails of all your bookmarks	bookmarks
automatic theme switcher skins google chrome	google_chrome
open in google chrome extension does just that	google_chrome
run google chrome in ubuntu with wine	google_chrome ubuntu wine
add-on compatibility reporter enables incompatible firefox extensions, reports if still not working	compatibility firefox firefox_extensions firefox_extension extensions extension
make your extensions work with firefox 3.6	firefox extensions
firefox 3.6 beta 3 available with 90+ bugs squashed	firefox_3.6 beta firefox
firefox 3.6 beta 2 available for download	firefox_3.6 firefox firefox_3.6_beta
firefox 3.6 beta 1 officially available for download	firefox_3.6 firefox firefox_3.6_beta
firefox 3.6 beta 1 "test build" now available	firefox_3.6_beta_1 firefox_3.6 firefox
firefox 3.6 alpha adds tab previews, boosts startup time	firefox_3.6 firefox_3.6_alpha alpha
firefox 3.1 adds tab preview panel	firefox firefox_3 firefox_3.1
early look at firefox's private browsing mode	firefox
firefox 3.7 alpha is a really rough look at firefox 4.0	firefox_3.7 firefox_4.0 firefox alpha
firefox implements webgl for high-powered web graphics	firefox webgl graphics
internet explorer 9 officially released	internet_explorer_9 internet_explorer
opera 11.10 makes compressed turbo browsing even faster	opera
master multiple firefox profiles for more productive browsing	firefox profiles
quickly launch new firefox profiles with profileswitcher	firefox
maximize firefox 3.5's viewing area for your netbook	firefox firefox_3.5 netbook
the complete guide to avoiding online scams (for your less savvy friends and relatives)	scams
why i've switched from chrome to firefox 4	chrome firefox
ubisoft reworking splinter cell conviction? [updated]	ubisoft splinter_cell_conviction
how to fix annoyances with firefox 4's new look	firefox_4 annoyances firefox
customize firefox with userchrome.css	firefox css
stop firefox 4 from trimming url previews in the status bar	firefox firefox_4
from the tips box: windows 7 favorites, the firefox button, and checked baggage	from_the_tips_box tips
stop firefox from automatically entering "work offline" mode	firefox
make misspellings stand out even more in firefox's spell check	firefox spelling
free up memory with about:config tweaks in firefox 4	firefox memory firefox_4 tweaks about:config
how to search lifehacker.com using google	search google
make site-specific searches within google search results	google
how to perform nearly any task from your browser's address bar	address_bar
chromemailer makes gmail chrome's default mail handler	gmail email
shorten urls from your address bar	urls address_bar url
use a simple web app as a live countdown timer	timer
set chrome to run flash and other plug-ins on-demand only	chrome flash plug-ins
popular start page myfav.es updates with more sites, user accounts, and other customizations	start_page
fav4.org is a dead simple but very attractive start page	start_page
change google chrome's user agent string	google_chrome
read full magazines for free, with or without an iphone	free magazines iphone
get free wi-fi access on your laptop at starbucks, barnes and noble	free_wi-fi top wi-fi
ublock is a fast and lightweight alternative to adblock plus	adblock_plus
this just in: adblock plus still uses a lot of memory	adblock memory
popular firefox extensions leak memory	firefox firefox_extensions memory
the great suspender suspends memory-hungry chrome tabs you haven't used lately	chrome memory
disconnect 2 speeds up the web, protects you from third-party tracking	tracking
privacy-protecting add-on disconnect now keeps your browsing safe from hijacking	privacy hijacking disconnect
a guide to sniffing out passwords and cookies (and how to protect yourself against it)	passwords cookies
how to secure and encrypt your web browsing on public networks (with hamachi and privoxy)	how_to hamachi privoxy
how to encrypt all internet use on your android phone	android
how to turn your computer into the ultimate remote access media server	remote_access how_to
turn a pogoplug into a full-featured linux web server	pogoplug web_server linux
getting started with linux: the complete guide	linux
getting started with linux: why install linux?	linux
why did you make the switch to linux?	linux
the gaia '10 linux desktop	linux
set a rotating picture of the earth as your ubuntu wallpaper	wallpaper ubuntu
set a video as your wallpaper with vlc	video vlc wallpaper
secrets updates for snow leopard, still tweaks every dark corner of os x	tweaks snow_leopard
wallpaper juggler downloads and rotates fresh wallpaper	downloads wallpaper
five best wallpaper sites	wallpaper
best wallpaper site?	wallpaper
best wallpaper site: interfacelift	wallpaper
five best collaboration tools	collaboration_tools collaboration
best collaboration tool?	collaboration
best collaboration tool: email	collaboration
five best startup management tools	startup
best startup management tool?	startup
best startup management tool: ccleaner	startup
five best outlining tools	outlining
hive five: five best mind mapping applications	hive_five mind_mapping mind_map
five best mind mapping tools	mind_mapping
best mind mapping tool?	mind_mapping
five best small form factor pc cases	cases small pc_cases
best small form-factor pc case?	small
five best desktop computer cases	computer cases desktop computer_cases top
best desktop computer case?	computer desktop
most popular desktop computer case: cooler master haf x	computer desktop cooler_master haf
five best document scanners for going paperless	scanners paperless paper document
best document scanner for going paperless?	paperless paper
how i went completely paperless in two days	paperless
what's all the fuss about evernote? should i be using it?	evernote
avoid "everything buckets," aka why i can't get into apps like evernote	everything_buckets
how to automatically archive your life with ifttt and evernote	ifttt
how to supercharge all your favorite webapps with ifttt	webapps ifttt
everyday.me is a journaling app for iphone that writes itself	journaling
the evernote smart notebook by moleskine digitizes and automatically tags your handwritten notes	evernote moleskine notes
get things done with evernote using gtd templates	gtd evernote templates
the secret weapon combines gtd and evernote into one synchronized productivity system	productivity gtd evernote
five best productivity methods	productivity
best productivity method?	productivity
build your own productivity style by remixing the best	productivity
make your to-dos come to you with reqall	to-dos reqall
reqall rover is a location-based personal assistant for android (and we've got beta invites)	android
lazymeter helps you focus on today's tasks, tracks your productivity	productivity focus
penzen gives you truly distraction-free writing	writing
five best distraction-free writing tools	distraction writing
best distraction-free writing application?	distraction writing
best distraction-free writing tool: q10	distraction writing
use a timer as a productivity booster and sanity minder	timer productivity
top 10 ways to upgrade your daily routine	daily_routine routine top
diy money-shredding alarm clock motivates you to wake up	diy alarm_clock money
make a smoke alarm clock to wake even the soundest sleeper	sleep
wake up easier in the morning with a video alarm	morning
create a diy sunrise simulator to wake up peacefully	diy
use a camera to help see your clutter trouble spots	clutter
declutter by staging a mock buy-back	clutter
use the "this isn't my stuff" approach for radical decluttering	clutter
re-evaluate your office gear to simplify and declutter	clutter office
reboot your office to return to a clean workspace	office
organize desk drawers by importance for easiest access to essential items	desk
get more done by organizing "just enough"	organizing
the mac text expansion faceoff	text_expansion mac
how a hive mind mentality can make you capable of anything good, evil, and bizarre	evil hive_mind
how to survive a job that makes you miserable	job
would you take a pay cut for more job flexibility?	flexibility
staying productive with multiple devices and methods of communication	communication
is the multiple-monitor productivity boost a myth?	productivity
how to rebuild your attention span and focus	focus attention
five best virtual-desktop managers	desktop top
best virtual-desktop manager?	desktop
best virtual-desktop manager: compiz	desktop
five best disk defragmenters	defragment
best disk defragmenter?	defragment
best disk defragmenter: defraggler	defragment
five best video-sharing sites	video
best video-sharing site?	video
best video-sharing site: youtube	video
five best apartment search tools	search
best apartment search tool?	search
best apartment search tool: myapartmentmap	search
five best video players	video
best video player?	video
best video player: vlc	video
hack attack: apartment hunting 101	hack_attack
make the most of your multiple monitors in windows	windows multiple_monitors monitors
fix the "cursor drift" annoyance on dual monitors by tweaking one simple setting	dual_monitors monitors
the master list of new windows 7 shortcuts	windows_7 windows
maximize windows vertically with a double-click in windows 7	windows_7 windows
windows 7's best underhyped features	windows_7 windows feature
what's new in the windows 7 release candidate	windows_7_release_candidate windows_7 windows
windows 7 rc available for download now	windows_7 windows_7_rc windows
in 2009, microsoft still underestimates the web	microsoft
windows 7 beta available pulled; "no eta" on product keys	windows_7 windows
windows 7 beta product keys now available (for real!)	windows_7 windows_7_beta windows
windows 7 beta ready for (official) download	windows_7 windows
how to get in on the limited windows 7 beta 1 download	windows_7 windows_7_beta windows
how to get your windows 7 beta product key	windows_7 windows windows_7_beta
gmail, why hast thou forsaken me?	gmail
"windows cloud" operating system release within a month	windows
windows 7 release candidate features: virtual xp mode	windows_7 windows_7_release_candidate
windows 7 release candidate features: media streaming	windows_7 windows_7_release_candidate
windows 7 release candidate wallpaper: international	wallpaper windows_7_release_candidate
windows 7 release candidate wallpaper: nature	wallpaper windows_7 windows_7_release_candidate
windows 7 release candidate wallpaper: landscapes	wallpaper windows_7_release_candidate
windows 7 release candidate wallpaper: architecture	wallpaper windows_7_release_candidate
windows 7 release candidate wallpaper: characters	wallpaper windows_7_release_candidate
windows 7 release candidate wallpaper: scenes	wallpaper windows_7_release_candidate
how to boost your internet security with dnscrypt	security dns dnscrypt
how do i know if my vpn is trustworthy?	vpn
do i really need to worry about security when i’m using public wi-fi?	security wi-fi public_wi-fi
how to stay safe on public wi-fi networks	wi-fi
how to hack your own network and beef up its security with kali linux	security linux
welcome to lifehacker's fifth annual evil week	evil_week
how to turn your computer's firewall on and off for beginners	firewall
https everywhere keeps your personal information safe on over 1,400 sites, available for firefox and chrome	https_everywhere https firefox chrome
how to keep your facebook secure (by enabling https)	facebook https
facebook increases security by allowing https usage everywhere	facebook security
https everywhere now supports secure browsing on over 1,000 sites	https
https everywhere updates with more protection against firesheep	updates
nine common myths and misconceptions about viruses, examined and debunked	virus
what’s the difference between viruses, trojans, worms, and other malware?	malware
mcafee update shuts down xp machines	mcafee
how do you know if your download really has a virus?	virus
how to fix the mcafee restart debacle on your machines	how_to mcafee
how to stop windows from shutting down	how_to windows
shutdownguard stops automatic windows shutdown, restart	windows shutdown
shutdown, restart, and sleep vista from the keyboard	vista
build your own vpn to pimp out your gaming, streaming, remote access, and oh yeah, security	security vpn gaming streaming remote_access remote
five best vpn tools	vpn
which vpn tool is best?	vpn
best vpn tool: openvpn	vpn
five best music streaming services	streaming music
five best streaming music services	music streaming streaming_music streaming
music streaming service grooveshark shuts down	grooveshark
what's the best streaming music service?	streaming_music streaming music
best music streaming service: grooveshark	streaming music
best music streaming service?	streaming music
most popular streaming music service: grooveshark	music streaming streaming_music grooveshark
best streaming music service?	music streaming streaming_music
five best ebook stores	store ebook_store
best ebook store?	store ebook_store
five best banks for high-interest savings accounts	banks savings interest savings_accounts ing
best bank for high-interest savings accounts?	savings interest savings_accounts
five best desktop calendaring applications	calendaring desktop applications top
best desktop calendaring app?	calendaring
five best bittorrent clients	bittorrent
what's the best bittorrent client?	bittorrent
download music and tv shows in sequential order with utorrent	tv_shows tv music utorrent
the best bittorrent client for windows	bittorrent windows
learn the most common “hidden crapware” tricks to keep your system clean	crapware
how to automatically download virtually anything as soon as it's available	how_to
how to automatically download movies as soon as they're released with couchpotato	movies how_to
the best email client for windows	email_client windows email
the best plugins to supercharge thunderbird	thunderbird
should i be using a desktop email client?	email desktop top
thunderbird to slow down development, focus on "security and stability" only	thunderbird
the best email client for linux	email_client linux email
contacts add-on brings your web address books into thunderbird	contacts address_book thunderbird
mozilla contacts adds facebook and yahoo import, address bar searches	contacts mozilla
import outlook pst files into thunderbird with pst import	outlook thunderbird
skin thunderbird to look like leopard mail	thunderbird
download of the day: apple mail theme (thunderbird)	thunderbird
lubuntu breathes new life into your netbook without sacrificing the flexibility of a full-fledged desktop	ubuntu lubuntu top
five best email clients	email_clients email
best email client?	email
best email client: gmail	email
five best photo-printing sites	printing
use gmail's multiple inboxes feature to manage multiple addresses	gmail
gmail labs adds multiple inboxes	gmail_labs gmail inbox
consolidate multiple email addresses with gmail	email gmail
what does google apps for your domain actually do?	google
google releases gmail mobile 1.5	gmail gmail_mobile google
master the new gmail with these tips, shortcuts, and add-ons	gmail shortcuts
become a gmail master redux	gmail
ten gmail labs features you should enable	gmail_labs gmail
gmail gets 13 experimental new features	gmail
gmail macros and label colors	gmail
gmail product manager on imap and greasemonkey	gmail greasemonkey imap
your gmail feature wishlist?	gmail
set up a filtered response in gmail?	gmail
how offline gmail decides which messages to download	gmail offline
how to free up space in gmail	gmail
ask the readers: free up space in gmail?	gmail ask_the_readers
empty your inbox with gmail and the trusted trio	gmail
build advanced gmail filters and persistent searches	filters gmail
expand filter input, get serious about your filters	filters
gmail search operators work in filters, too	gmail
add gmail tasks to your firefox sidebar	gmail_tasks tasks
gmail adds tasks to the iphone, mobile browsers, and igoogle	gmail igoogle iphone
google talk launches for iphone; works great in sidebar	google_talk iphone sidebar
display your gcal agenda in firefox's sidebar	firefox sidebar
load any site in your firefox sidebar	sidebar
put google talk in your firefox sidebar	google_talk firefox google
open google notebook in the firefox sidebar	google_notebook firefox google sidebar
put facebook chat in firefox's sidebar	chat facebook firefox sidebar
facebook versus gmail web-based chat	chat facebook gmail
how to use and search gmail superstars	gmail
set up quick access to your gmail media	gmail media
xoopit transforms your gmail inbox into a multimedia haven	gmail
gmail rolls out its new, minimal look	gmail
don't like google calendar's new look? here's how to turn it off	google_calendar
how to use gmail as your central, universal communications hub	how_to gmail
back up your sms messages to a gmail label on android	sms android
top 10 gmail labs and features you should enable	gmail_labs gmail feature
gmail superstars and quick links make a killer to-do list	gmail to-do_list
use gmail's canned responses for smarter autoresponders	gmail
gmail adds canned responses for quick replies	gmail
geek to live: knock down repetitive e-mail with thunderbird's quicktext	geek_to_live thunderbird
gmail canned responses brings quick email replies to android	gmail android canned_responses email
assign email a 15-minute minimum to avoid unnecessary checking	email
a case for singletasking: the one-task-at-a-time method	singletasking
poor attention span? no, you're just multitasking	multitasking
multitasking mania	multitasking
the end-all guide to getting out from under your office crap	office
the one-box system minimizes time spent filing	filing
cut down on office clutter with a record retention policy	clutter
tough questions to help you declutter	clutter
declutter your home with the suitcase test	clutter home
use the "one in, two out" rule to declutter	clutter
form an attack plan for a cluttered, messy home	clutter
clean your workspace—and keep it that way	workspace
de-clutter with a six-month "maybe box"	clutter
how do you clear your messy desk?	desk
keep hanging folders from sliding with binder clips	folders
take pictures to dispose of "sentimental clutter"	clutter
create a stuff replacement fund to declutter and make money	clutter
a seller's guide to craigslist	craigslist
declutter an entire room in a single sweep	clutter
why you hold on to clutter	clutter
tame clutter by asking "how much is enough?"	clutter
ditch forgotten items to purge hidden clutter	clutter
kill desktop clutter by banishing transient stuff	clutter desk top
tame your counter clutter by creating homes for your belongings	clutter home
set a goal to guide your decluttering	clutter
get rid of your clutter crutches to finally get clean	clutter
clean out your to-do list for guilt-free productivity	to-do_list productivity
cancel sending emails by quickly pulling out your ethernet cable	email
change the delay time on gmail's undo send	undo_send gmail
undo send gives you five seconds to stop a bum email	email undo
10 more experimental features you should enable from the gmail laboratory	gmail
better gmail 2 and better flickr updated	better_gmail flickr better_flickr gmail
fix gmail's newest annoyances with these userstyles and userscripts	gmail userscripts userstyles annoyances
gmail rolls out attractive new look: better conversations, improved search, adapts to your screen	gmail
google reader rolls out a new, clean, google plus-integrated interface	google_reader reader google
make labels stand out, create filters, and other things you may be confused about with the new gmail	gmail labels filters
minimalist gmail is the best gmail tweaker for chrome yet	gmail chrome
unofficial better gmail for chrome bends gmail to your will	gmail better_gmail chrome
better gmail update now available	better_gmail gmail
better gmail for google chrome	better_gmail gmail google_chrome
top 10 things you forgot gmail can do	gmail top
geek to live: back up gmail with fetchmail	gmail geek_to_live
backing up gmail with thunderbird	gmail thunderbird
geek to live: eight killer thunderbird extensions	thunderbird geek_to_live thunderbird_extensions
download of the day: quick file (thunderbird)	thunderbird
download of the day: tb quickmove extension (thunderbird)	thunderbird
download of the day: gmailui (thunderbird)	gmail thunderbird
ask lifehacker: gmail or thunderbird?	thunderbird ask_lifehacker gmail
download of the day: mailredirect (thunderbird)	thunderbird
download of the day: gexodus gmail export tool	gmail
gmail gives you more control of your contacts	gmail contacts
how do you get new gmail notifications?	gmail notification notifications
getting to done: communication - a guide to email triage	getting_to_done email communication
how to stop checking email on the evenings and weekends	email top
separate your email from your to-do's	email
gmail labs adds forgotten attachment detector	gmail gmail_labs
gmail labs adds three new reply features	gmail gmail_labs
how to set up gmail, google calendar, and google contacts (properly) on ios	gmail google ios google_calendar
get google and ios living together in perfect harmony	google ios
top 10 awesome android features that the iphone doesn't have	android feature top
swiftkey steps up text prediction on android	android text
swype beta brings better typing to android, free for next few days	swype android typing
thickbuttons predicts and enlarges letters for better android typing	typing android
get a better android keyboard, no rooting required	android keyboard
8pen is a speedy gesture-based keyboard for android phones	keyboard android
slideit is a pretty accurate swipe-based android keyboard	keyboard android
five alternative android keyboards to speed up mobile touch typing	android android_keyboards keyboards
how to turn your android phone into a fully-automated superphone	android
three handy tasker profiles from our readers	tasker
push your automated android to awesome heights with these tasker setups	android tasker
dropbox adds easy web sharing of any folder	dropbox sharing
how to roll your own "find my iphone" for android	find_my_iphone android how_to
juicedefender simplifies automated android battery saving	android battery
juicedefender saves batteries by automating android data	android
apndroid 2.0 adds automation to android battery saving tool	android battery
apndroid switches mobile data for better android battery life	android battery mobile data
an exhaustive guide to saving your smartphone's battery	battery smartphone
set up "push" gmail on your iphone	iphone
google sync keeps contacts and calendars in sync on your mobile phone	google calendars contacts
google sync for blackberry now bi-directional	blackberry google
gpush brings push notification to gmail users on the iphone	gmail iphone
gmail growl 1.5 improves push notifications for iphone with prowl	iphone push_notifications growl
google sync updates with push gmail support	google_sync gmail google
how to make your iphone (or other ios device) more like android	ios android
how to install android on an iphone in six easy steps	how_to
mobilenotifier is a near-perfect ios notifications replacement for jailbroken ios devices	ios notifications
why you should use appbrain to install and manage your android apps	android appbrain
how can i tell if an android app is malware?	android malware
cyanogenmod 7 brings gingerbread, sms gestures, and built-in overclocking to android	cyanogenmod gingerbread android
find out if your android phone is getting gingerbread (and when)	android gingerbread
please help me understand the android releases	android
screenshot tour of android 2.3 gingerbread and its best new features	screenshot_tour gingerbread android_2.3 android
google launches android 2.3 gingerbread and nexus s flagship phone	android gingerbread android_2.3 nexus_s
appbrain upgrade installs android apps instantly from the web	android web
google announces android 2.2 with flash, google tv at i/o conference	android google_tv android_2.2 google
android 2.2 could include built-in tethering and wi-fi hotspot sharing	android tethering tether wi-fi hotspot
google may solve android fragmentation problems with next release	android google
when it doesn't pay to be google's guinea pig	google
gmail, google calendar, docs, and talk leave beta	google gmail google_calendar beta
